17777777777777777772
5000F0F000000F0F0006
50G0CED0IEEH0CED0G06
50F00000000000000F06
50CEH0IEEH0IEH0IED06
50000000000000000006
5EEB0G00000000G0AEE6
500F0F0AE0EEB0F0F006
500F0F0FSSSSF0F0F006
500F0F0CEEEED0F0F006
500F0F00000000F0F006
5EED0J0IEEEEH0J0CEE6
50000000000000000006
50AEEH0IEEEEH0IEEB06
50F00000000000000F06
50J0G0IEEEEEEH0G0J06
5000F0000000000F0006
50IEKEEH0AB0IEEKEH06
500000000FF000000006
38888888888888888884